24 32
................................
................................
.......####.....................
.......#..#..........##.##......
.......####.........#######.....
.......#.............#####......
.......##.............###.......
......####.............#........
......#..##.....................
......#...##....................
####..#....#....................
................................
................................
.....#########..................
................................
................................
................................
.....#########..................
................................
################................
........................#.......
.......................#.#......
......................#.#.#.....
################.......#.#......