32 32
################################
################################
################################
################################
##............................##
##............................##
##............................##
##............................##
########................########
##............................##
##............................##
##............................##
##............................##
##.....#................#.....##
##.....#.##############.#.....##
##............................##
##............................##
##............................##
##............................##
#########..............#########
##............................##
##............................##
##............................##
##............................##
##.......##############.......##
##............................##
##............................##
##............................##
##............................##
########...##########...########
########...##########...########
########...##########...########